NO ./textures/Brick.xpm
SO ./textures/Metal.xpm
WE ./textures/Tile.xpm
EA ./textures/Wood.xpm

F 173,173,173
C 51,227,255

111111111111
100000000001      11111
1000000000011111111000111111    111111111111111
10000N0000000000000000000001    100000000000001
1000000000011111111000111101    100000000000001
100000000001      11011  101    100000000000001
111111111111       101   1011111100000000000001
                   101   1000000000000000000001
        1111111111110111 1011111100000000000001
        1000000000000001 101    100000000000001
        10010010010010011101    100000000000001
        10000000000000000001    100000000000001
        10010010010010011111    111111111111111
        1000000000000001
        1111111001111111
              1001
              1001
            11100111
        1111100000011111111
        1000000000000000001
        1000000000000000001
        1111100000011111111
            11111111