NO ./textures/julia_fourth_x4096.xpm
SO ./textures/cyberpunk_x2048.xpm
WE ./textures/neon_sunset_x2048.xpm
EA ./textures/magic_wall_x2048.xpm
F 220,100,12
C 225,30,87

        1111111111111111111111111        1111111111111111111111111
        1000000000110000000000001        1000000000110000000000001
        1011000001110000000000001        1011000001110000000000001
        1001000000000000000000001        1001000000000000000000001
111111111011000001110000000000001111111111011000001110000000000001
1000000000110000011101111111111111000000000D0000001110111111111111
11110111111111011100000010001    1111D111111111011100000010001
11110111111111011101010010001    11110111111111011101010010001
110000001101010111000000D0001    110000001101010111000000D0001
10000000000000001100000010001111110000000000000001100000010001
1000000000000000110101001000D0000D0000000000000001101010010001
11000001110101011111011110N01111111000001110101011111011110001
11110111 1110101 101111010001    11110111 1110101 101111010001
11111111 1111111 111111111111    11111111 111D111 111111111111
        1111111111111111111111D11        1111D11111111111111111111
        1000000000110000000000001        1000000000110000000000001
        1011000001110000000000001        1011000001110000000000001
        1001000000000000000000001        1001000000000000000000001
111111111011000001110000000000001111111111011000001110000000000001
1000000000D00000011101111111111111000000000D0000001110111111111111
1111D11111111101110000001000100001111D111111111011100000010001
11110111111111011101010010001000011110111111111011101010010001
110000001101010111000000D00010000110000001101010111000000D0001
10000000000000001100000010001000010000000000000001100000010001
100000000000000011010100100010000D0000000000000001101010010001
11000001110101011111011110001110011000001110101011111011110001
11110111 1110101 101111010001000011110111 1110101 101111010001
11111111 1111111 111111111111111111111111 1111111 111111111111