NO ./textures/north.xpm
SO ./textures/south.xpm
WE ./textures/west.xpm
EA ./textures/east.xpm
F 220,100,12
C 225,30,87

111111111111
100000000001
100011D11001
100010001001
100010001001
100010001001
1000D0N0D001
100010001001
100010001001
100011D11001
100000000001
111111111111
111111111111